1111111111111111111
1S...............Z1
1.................1
...................
...................
1.................1
1.................1
1.................1
1.................1
1.................1
1.................1
1.................1
1.................1
1.................1
1.................1
1.................1
1.................1
1Z...............S1
1111111111111111111