1111111111111111111111
1Q.......J..........Q1
1....................1
#....................1
#....................1
1....................1
1....................1
1....................1
1....................1
1....................1
1....................1
1....................1
1....................1
1....................1
1....................1
1111111111111111111111