1111111111111111111111
1........J...........1
1....................1
.....................1
.....................1
1....................1
1....................1
1....................1
1....................1
1....................1
1....................1
1....................1
1....................1
1....................1
1....................1
1111111111111111111111