111111111111
1..........1
1..........1
1..........1
#..........#
#..........#
1..........1
1..........1
1..........1
1..........1
1..........1
1..........1
1..........1
1..........1
1..........1
1..........1
1....EE....1
1..........1
1S........S1
111111111111