11111..11111
1S........S1
1..........1
1.....E....1
............
............
1..........1
1..........1
1..........1
1..........1
1..........1
1..........1
1..........1
1..........1
.....EE.....
............
1..........1
1..........1
1..........1
11111..11111