1111111111111
1D.........D1
1...........1
1...........1
#...........#
#...........#
1.....I.....1
1...........1
1...........1
1...........1
1...........1
1D.........D1
1111111111111