11111##1111111111##11111
1Z....................S1
1......................1
1......................1
#......................#
#.........EEE..........#
1......................1
1......................1
1......................1
1......................1
1......................1
1......................1
1......................1
1......................1
#......................#
#.........EEE..........#
1......................1
1S.....................1
1.....................Z1
11111##1111111111##11111