11111..1111111111..11111
1......................1
1......................1
1......................1
........................
........................
1......................1
1......................1
1......................1
1......................1
1......................1
1......................1
1......................1
1......................1
........................
........................
1......................1
1......................1
1......................1
11111..1111111111..11111