111111111111111111111111
1Z.....................1
1......................1
1......................1
#......................#
#......................#
1......................1
1......................1
1......................1
1......................1
1......................1
1......................1
1......................1
1......................1
1......................1
1......................1
1.......EEE............1
1.....................S1
1S....................Z1
111111111111111111111111