11111111111111111111111111111111111111111
1Z...................Z.................Z1
1.......................................1
1.......................................1
#.......................................#
#.......................................#
11111111111111111111111111111111111111111